#################
#→↓ →→→↓        #
# →→↑↓←←        #
#    ↓          #
#    ↓          #
#    →↓→↓       #
#     →↑→→→→↓   #
#  ↓←←←   ↓←←   #
#  ↓→↓↑↓←←←     #
#  →↑↓↑←        #
#    ↓↓←        #
#    ↓ ↑        #
#    →→↑        #
#               #
#               #
#               #
#################
